1111111111111111111000000000000000000000000000000000000000000000000000000000000000000001111111111111
1111111111111110011100000000000000000000000000000000000000000000000000000000000000000011111111111111
1111111111111110011100000000000000000000000000000000000000000000000000000000000000001111111111111111
1111111111111111001110000000000000000000000000000000000000000000000000000000000000001110111111111111
1111111111111111011110000000000000000000000000000000000000000000000000000000000011111111101111111111
1111111111111111011111000000000000000000000000000000000000000000000000000000000010011111111111111111
1111111111111111011111000000000000000000000000000000000000000000010000000000000111111111111111111111
1111111111111111011111101000000000000000000000000000000000000000110000000001011111111111111111111111
1111111111111111011111111000000000000000110000000000000000000001110000000011111111101111111111111111
1111111111111111000011111100000000000011110000000000000000110111110000000010011111100111111111111111
1111111111111111111000000011000000000011111100100000011000110111100000000011011011110111111111111111
1111111111111111111111111011110111000111111000101000011000111111110000000001111111111111111111111111
1111111111111111111111111001111111222111111100111001011111111001110111000000111111011111111111111111
1111111111111111111111111101111111111111111111111001111110110111100111000001111111111111111111111111
1111111111111111111111111110111111101111111111111111111111111111001111100011110111111111111111111111
1111111111111111111111111110011000010111110001111111111111111111111111111110110011011111111111111111
1111111111111111111111111111011111111111111110000110010111000111110000111100111001111111111111111111
1111111111111111111111111111111111100000111111111111111111001111110110111011111101111111111111111111
1111111111111111111111111111111000011101110111111101111110011011101111110111111111111111111111111111
1111111111111111111111111111110011111111111000000001110000111111101111101110111111111111111111111111
1111111111111111111111111111111111111111111111111110100101111111000111011111111111111111111111111111
1111111111111111111111111111111111111111111111111111111111111111011111011111111111111111111111111111
1111111111111111111111111111111111111111111111111111111111111111111111101111111111111111111111111111
1111111111111111111111111111111111111111111111011111111111111111111111111111111111111111111111111111
1111111111111111111111111111111111111111111111111111111111111111111111111111111111111111111111111111
1111111111111111111111111111111111111111111111111111111111111111111111111111111111111111111111111111
1111111111111111111111111111111111111111111111111111111111111111111111111111111111111111110110011111
1111111111111111111111111111111111111111111111111111111111111111111111111111111111111111000000001111
1111111111111111111111111111111111111111111111111011111111111111111111111111111111111110000000000222
1111111111001111111111111111111111111111111002220001001111111111111111111111111111111110000000000000
1111111111000011111111111111111111111111111000000000000111111111111111111111111111111100000000000000
1111111010000001111111111111111111111101110000000000001111111111111111111111111111111000000000000000
1111111000000001111111111111111111110111100000000000001111111111111111111111111111111000000000000000
1111110000000000111111111111111111111111100000000000000011111111111111111111111111111000000000000000
1111100000000000011111111111111111111100000000000000000010111001111111111111111111110000000000000000
1111100000000000011111111111111111111100000000000000000000011001100111111111111111111100000000000000
1111110000000000111101111111111111111100000000000000000000000000000111111111111111111100000000000000
1111110000000000001110111111111111101000000000000000000000000000000111111111111111111000000000000000
1111110000000000011111111111111111111000000000000000000000000000000011111111111111111000000000000000
1111100000000000111111111111111111010000000000000000000000000000000111111111111111111100000000000000
1111000000000000100111011111111111110000000000000000000000000000011111111111111111110000000000000000
1110000000000000000011101111111110110000000000000000000000000000011111111111111111110000000000000000
1111000000000000000011111111111111111100000000000000000000000000001111111111111111110000000000000001
1111000000000000001111111111111111111100000000000000000000000111111111111111111111110000000000000011
1111000000000000011111011011111101100110000000000000000000110111111111111111111111100000000000000111
1111100000000000111111111111110110111111000000000000000000111111111111111111111111000000000000000111
1111110000000011111101111110111011111011000000000000000001111111111111111111111111100100000000001111
1111110000000000011001111111111011110000000000000001001000111111111111111111111111111110000000000011
1111110000000000000000001111111110110000000010000001111000011111111111111111111111111110000000000001
1111111000000000000000003333333333330000000011101111111000000011111111111111111111111111100000000001
1111111110000000222000111111111111111000011111111111111000000111111111111111111111111111100000000001
1111111100000000011001111011111111111100011111111111110000000001111111111111111111111110000000000111
1111111000000000011111011111111111101100001111111111100000000011111111111111111111111111100000000111
1111010000000000111101111111111111110111101011101111110000010011111111111111111111111111111100000011
1111000000000001111111110111111111111111100000000111111100111111111111111111111111111111111100000111
1111000000011011111111111111111111111111110000000111111110111111111111111111111111111111111100011111
1111110000111111110101111111111110111011111000001111111111111111111111111111111111111111111110111111
1111110000111110111111111110111111111111101100011111111111111111111111111111111111111111111111111111
1111111011111111111111011111111111111111111111111111111111111111111111111111111111111111111111111111
1111111111111111111111111111111111111110110111101111111111111111111111111111111111111111111111111111
1111111111111111111111111111111111111111111111111111111111111111111111111111111111111111111111111111
1111111111111111111111111111111111111111111111111111111111111111111111111111111111111111111111111111
1111111111111111111111111111111111111111111111111111111111111111111111111111111111111111111111111111
1111111111111111111111111111111111111111111111111111111111111111111111111110111111111111111111111111
1111111111111111111111111111111111111111111111111111111111111111111111111100111111111111111111111111
1111111111111111111111111111111111111111111111111111111111111111111111111100011111111111111111111111
1111111111111111111111111111111111111111111111111111111111111111111111111100000111111111111111111111
1111111111111111111111111111111111111111111111111111111111111111111111111100000111111111111111111111
1111111111111111111111111111111111111111111111111111111111111111111001110000000001111111111111111111
1111111111110000000000111111111111111111111111111111111111111111111001110000000111111111111111111111
1111111111110000000000111111111111111111111111111111111111111111110000000000001111111111111111111111
1111111111110000000000111111111111111111111111111111111111111110110000000000001111111111111111111111
1111111111110000000000111111111111111111111111111011111111111110000000000000011111111111111111111111
1111111111110000000000111111111111111111111111111011111111111100000000000000011111111111111111111111
1111111111110000000000111111111111111111111111110001111111111100000000000000111111111111111111111111
1111111111110000000000111111111111111111111110000000111111111110100000000001111111111111111111111111
1111111111110000000000111111111111111111111110000001111111111111100000000101111111111111111111111111
1111111111110000000000111111111111111111111110000001111111111111000000001111111111100111111111111111
1111111111110000000000111111111111111111111111000001111111111111000000000022211111100011111111111111
1111111111110000000000111111111111111111111111110001111111111111000000000000011110000001111111111111
1111111111110000000000111111111111111111111111110000011111111111000000000000011000000001111111111111
1111111111110000000000111111111111111111111111100000000111111111000000000000010000000011111111111111
1111111111110000000000111111111111111111111111000000000111111000000000000000010000000111111111111111
1111111111110000000000111111111111111111111100000000000111011000000000000000000000001111111111111111
1111111111110000000000111111111111111111111100000000000000000000000000000000000011111111111111111111
1111111111110000000000111111111111111111111000000000000000000000000000000000000000111111111111111111
1111111111110000000000111111111111111111111000000000000000000000000000000000000000011111111111111111
1111111111110000000000111111111111111111111100000000000000000000000000000000000000111111111111111111
1111111111110000000000111111111111111111111110110000000000000000000000000000000000011111111111111111
1111111111110000000000111111111111111111111111110000000000000000000000000000000000011111111111111111
1111111111110000000000111111111111111111111110000000000000000000000000000000000000111011111111111111
1111111111110000000000111111111111111111110010000000000000000000000000001101000000000001111111111111
1111111111110000000000111111111111111111100000000000000000000000000000011111000000000011111111111111
1111111111110000000000111111111111111111000000000000000000000000000000111111000000001111111111111111
1111111111110000000000111111111111111111000000000000000000000000000001111111100000111111111111111111
1111111111110000000000111111111111111111100000010000000000000000000000011111110001111111111111111111
1111111111111111111222111111111111111111111000111000000000000000000000111111110111111111111111111111
1111111111111111111111111111111111111111111111110000000000000000000000111111111111111111111111111111
1111111111111111111111111111111111111111111111100000000000000000000000011111111111111111111111111111
1111111111111111111111111111111111111111111111111100000000000000000000111111111111111111111111111111
